X,X,X,X,X,X,X,X,X,X,X,X,X
X,_,_,_,_,_,_,_,_,_,_,_,X
X,_,X,_,X,_,X,_,X,_,X,_,X
X,_,_,_,_,_,_,_,_,_,_,_,X
X,_,X,_,X,_,X,_,X,_,X,_,X
X,_,_,_,_,_,_,_,_,_,_,_,X
X,_,X,_,X,_,X,_,X,_,X,_,X
X,_,_,_,_,_,_,_,_,_,_,_,X
X,_,X,_,X,_,X,_,X,_,X,_,X
X,_,_,_,_,_,_,_,_,_,_,_,X
X,_,X,_,X,_,X,_,X,_,X,_,X
X,B,_,_,_,_,_,_,_,_,_,_,X
X,X,X,X,X,X,X,X,X,X,X,X,X
,,,,,,,,,,,,
,,,,,,,,,,,,
,,,,,,,,,,,,
,,,,,,,,,,,,
,,,,,,,,,,,,
